---------------------------------------------------------------------------------------------------------------------------------------------------------------------------------------
---------------------------------------------------------------------------------------------------------------------------------------------------------------------------------------
---------------------------------------------------------------------------------------------------------------------------------------------------------------------------------------
---------------------?SSS---------------------?????-----------?SSS--------SS?SS------SSSS-----------------------------?SSS-----------------------------------SSSSS---?-----------------
---------------------------------------------------------------------------------------------------------------------------------------------------------------------------------------
---------------------------------------------------------------------------------------------------------------------------------------------------------------------------------------
-----------------X---------------------------------------------------------------------------------------------------------[]----------------------------------------------------------
--------S?S-----XX---?-----X-----------[]-----?????----------S-----[]---????--???---------------[]-----------------[]------[]-----------------------------?--------?--------------SS---
---------------XXX---------X-----------[]--------------------------[]---------------------------[]-----------------[]--[]--[]----------------------X---------------------[]------------
--------------XXXX---------XX----------[]--------------------------[]---------------------------[]----------[]-----[]--[]--[]----------------------X---------------------[]------------
-------------XXXXX---------XX----------[]--------------------------[]---------------------------[]----------[]-----[]--[]--[]----------------------X---------------------[]------------
XXXXXXXXXXXXXXXXXXXXXXXXXXXXXXXXXXXXXXXXXXXXXXXXXXXXXXXXXXXXXXXXXXXXXXXXXXXXXXXXXXXXX----XXXXXXXXXX---XXXXXXXXXXXXXXXXXXXXXXXXXXXXXX---XXXXXXXXXX--XXXXXXXXXXXXXXXXXXXXXXXXXXXXXXXXXXXX
