----------------------------------------------------------------------------------------------------------------------------------------------------------------------------------------------------------
----------------------------------------------------------------------------------------------------------------------------------------------------------------------------------------------------------
----------------------------------------------------------------------------------------------------------------------------------------------------------------------------------------------------------
----------------------------------------------------------------------?-------------------------------------------------------------------------------------------------------------------------XX--------
-----------------------------------------------------?-----------------------------------------------------------------S-----------------------------------------------------------------------XXX--------
----------------------------------------------------------------------------------------------------------------------------------------------------------------------------------------------XXXX--------
---------------------------------------------------------------------------------------------------------------------------------------------------------------------------------------------XXXXX--------
----------------------------------------------------------------------?---------------------------------------------------------------------------------------------------------------------XXXXXX--------
-----------------------------------------------------X------------------------------------------------------------------------------------------------------------[]-----------------------XXXXXXX--------
-----------------------------------------------------X--------------X---X----------------------------------------------X------------------------------------------[]----------------------XXXXXXXX--------
------------------------------------------X----------X--------------X---X----------------------------------------------X------------------------------------------[]---------------------XXXXXXXXX--------
XXXXXXXXXXXXXXXXXXXXXXXXXXXXXXXXXXXXXXXXXXXXXXXXXXXXXXXXXXXXXXXXXXXXXXXXX--XXXXXXXXXXXXXXXXXXXXXXXXXXXXXXXXXXXXXXXXX--XXX--XXXXXXXXXXXXXXXXXXXXXXXXXXXXXXXXXXXXXXXXXXXXXXXXXXXXXXXXXXXXXXXXXXXXXXXXXXXXXXX
