--------------------------------------------------------------------------------------------------------------------------------------------------------------------------------------------------------------------------
--------------------------------------------------------------------------------------------------------------------------------------------------------------------------------------------------------------------------
--------------------------------------------------------------------------------------------------------------------------------------------------------------------------------------------------------------------------
------------------?--------------------------------------?-?-------------------------?-------------------------------------------------------????---------------------------------------------------------------XX--------
---------------------------------------------------------------------------------------------------------------------------------------------------------------------------------------------------------------XXX--------
--------------------------------------------------------------------------------------------------------------------------------------------------------------------------------------------------------------XXXX--------
-------------------------------------------------------------------------------------------------------------------------------------------------------------------------------------------------------------XXXXX--------
------------------?--------------------------------------?-?-----------------------????----------------------[]--------------[]------------???SS???---------------------------------------------------------XXXXXX--------
--------------[]--------------------------------------------------------------------------------X------------[]--------------[]-------------------------------------------------------X--------------------XXXXXXX--------
--------------[]--------------------------------------------------------------------------------X------------[]--------------[]-----------------------------[]------------------------X-------------------XXXXXXXX--------
--------------[]--------------------------------------------------------------------------------X------------[]--------------[]-----------------------------[]------------------------X------------------XXXXXXXXX--------
XXXXXXXXXXXXXXXXXXXXXXXXX--XXXXXXXXXXXXXXXXXXXXXXXXXXXXXXXXXXXXXXXXXXXX----XXXXXXXXXXXXXXXXXXXXXXXXXXXXXXXXXXXXXXXXXXXXXXXXXXXXXXXXXXXXXXXXXXX--XXXXXXXXXXXXXXXXXXXXXXX---XXX--XXXXXXXX--XXXXXXXXXXXXXXXXXXXXXXXXXXXXXXXXX
