--------------------------------------------------------------------------------------------------------------------------------------------------------------------------------------------------------
--------------------------------------------------------------------------------------------------------------------------------------------------------------------------------------------------------
--------------------------------------------------------------------------------------------------------------------------------------------------------------------------------------------------------
------------------------------------------------------SSSSSSSSSS-------------------------------------------------------------------------------------------------------------------------------XX-------
--------------------------------------------------------------------------------------------------------------------------------------------------------------------------------------------------------
--------------------------------------------------------------------------------------------------------------------------------------------------------------------------------------------------------
----------------------------------------------------------------------X----------------------------------------[]-----------------------------------------------------------------------X---X-----------
--------------------------------------------------------------SSSSSSSSX----------------------------------------[]----?????????-------------------------------------???????-----------X------------------
--------------?--------S??-------------------------------X-----------------------------------------------------[]-------------------------------------XXXXXXXXXXXXX------------------X------------------
---------------------------------------------------------X-----------------------------------------------------[]-----------------------S------------------------------------[]------X------------------
---------------------------------------------------------X-----------------------------------------------------[]------------------------------------------------------------[]------X--------X---------
XXXXXXXXXXXXXXXXXXXXXXXXXXXXXXXXXXXXXXX--XXXXXXX--X-XXXXXXXXXXXXXXXXXXXXXXXXXXXXXXXXXXXXXXXXXXXXXXXXXXXXXXXXXXXXXXXXXXXXXXX-XXXXXXXXXXXX-XXXXXXXXXXXXXXXXXXXXXXXXXXXX-[][]---XXXXXXXXX----XXXXX---------
