--------------------------------------------------------------------------------------------------------------------------------------------------------------------------------------
--------------------------------------------------------------------------------------------------------------------------------------------------------------------------------------
--------------------------------------------------------------------------------------------------------------------------------------------------------------------------------------
-----------XSSSSS---------------------------------SSSSSSSSSSSSSS---SSSS-SSSSSSSSSSSSS----------------------------------SSSSSS-----------------------------------------------XX--------
-----------X---------------------------------------------------------------------------------------------------------------------------------[]----------------------------XXX--------
-----------X---------------------------------------------------------------------------------------------------------------------------------[]---------------------------XXXX--------
-----------X----X--------------------?--------------------------------------------------X----------------------------------------------------[]--------------------------XXXXX--------
-----------XSSSSX---?????--------[]-----------------SSSSSSSSSSS--XS--------------???????X----------------------------[]---[]------------[]--????------------------------XXXXXX--------
---------------------------------[]-----------------------------XX---------------------------------------------------[]---[]------------[]-----------------------------XXXXXXX--------
---------------------------------[]----------------------------XXX---------------------------------------------------[]---[]------------[]-------------------[]-------XXXXXXXX--------
---------------------------------[]---------------------------XXXX-----------X---------------------------------------[]---[]------------[]-------------------[]------XXXXXXXXX--------
XXXXXXXXXXXXXXXXXXXXXXXXXX[]XXXXXXXXXXX[]XXXXXX---XXXXXXXXXXXXXXXXXXXX-------XXXXXXXXXXXXXXXXXXXXXXXXXXXXXXXXXXXXXXXXXX---XX--XXXXXXXXXXXXXXXXXXX---XXXXXXXXXXXXXXXXXXXXXXXXXXXXXXXXXX
