---------------------------------------------------------------------------------------------------------------------------------------------------------------------------------------------------------------------------------------------------------------------------------------------------------------------------------------------------------------------------------
---------------------------------------------------------------------------------------------------------------------------------------------------------------------------------------------------------------------------------------------------------------------------------------------------------------------------------------------------------------------------------
---------------------------------------------------------------------------------------------------------------------------------------------------------------------------------------------------------------------------------------------------------------------------------------------------------------------------------------------------------------------------------
---------------------------------------------------------------------------------------------------------------------------------------------------SSSS?SSS------------------------------------------------------------------------------------------------------------------------------------------------------------------------------------------------------------XX--------
-----------------------------------------------------------------------------------------------------------------------------------------------------------------------------------------------------------------------------------------------------------------------------------------------------------------------------------------------------------------------XX--------
---------------------------------------------------------------------------------------------------------------------------------------------------------------------------------------------------------------------------------------------------------------------------------X-----------------------------------------------------------------------------------X-XX--------
-------------------------------------------------------------------------?-------------------------------------------------------------------------------------------------------SS?SSSSS------------------------------------------------------[]-------------------------------XX-----------------------------------------------------------------------------------X-XX--------
----------------------------[]---------------------------------------[]----------------[]--------[]-----------------------------------------------X----?----X------------------------------------------------------------------------------[]--[]------------------------------XXX---------------------------------------------------------------------------------X-X-XX--------
----------------------------[]---------------------------------------[]----[]----------[]--------[]----------------------------------[]-----------X---------X--------------------------------------------------------------------------[]--[]--[]-----------------------------XXXX---------------------------------------------------------------[]----------------X-X-XX--------
----------------------------[]---------------------------------------[]----[]----------[]--------[]---------[]-----------------------[]-----------X---------X----------------------------------------------X---------------------------[]--[]--[]----------------------------XXXXX----------------------X---X------------------------------------[]---------[]---X-X-X-XX--------
----------------------------[]---------------------------------------[]----[]----------[]--------[]---------[]-----------------------[]-----------X---------X----------------------------------------------X---------------------------[]--[]--[]---------------------------XXXXXX----------------------X---X------------------------------------[]---------[]---X-X-X-XX--------
XXXXXXXXXXXXXXXXXXXXXXXXXXXXXXXXXXXXXXX-X-XX-XX-XX-XXXXXXXXXXXXXXXXXXXXXXXXXXXXXXXXXXXXXXXXXXXXXXXXXXXXXXXXXXXXXXXXXXXXXXXXXXXXXXXXXXXXXXXXXXXXXXXXXXXXXXXXXXXXXXX-X-XX-X-XX-XXXXXXXXXXXXXXXXX-X-X-XXXXXXXXXXXXXXXXXXX------XXXXXXXXXX-XX--XX--XXXXXXXXXXXXXXXXXXXXXXXXXXXXXXXXXXXXXXXXXXXX---XX---XXXXXXXXXXXXXXXX-----X----XXXXXXXXXXXXXXXXXXXXXXXXXXXXXXXXXXX-X-X-X-XXXXXXXXXX
