-------------------------------------------------------------------------------------------------------------------------------------------------?--------------------------
----------------------------------------------------------------------------------------------------------------------------------------------------------------------------
----------------------------------------------------------------------------------------------------------------------------------------------------------------------------
--------------------?SS----------------------------------------------------SSSSSSS----?----------------------------------------SSSSS------------------------------XX--------
--------------------------------------------------------------------------------------------------------------------------------------------------SS-------------XXX--------
-------------------------------------------------------------------------------------------------------------------------------------------------------X--------XXXX--------
----------------------------------------------------------------------------------------------------------------------------------------------SS------XX-------XXXXX--------
--------------------------------????-------------------SSX?S---------------SSSSSSS---------------------------------------------SSSSS-----------------XXX------XXXXXX--------
---------------------------------------------------------------------[]---------------[]--------------[]------------------------------X-------------XXXX-----XXXXXXX--------
---------------------------------------------------------------------[]---------------[]--------------[]----[]-----------[]-----------X------------XXXXX----XXXXXXXX--------
---------------------------------------------------------------------[]---------------[]--------------[]----[]-----------[]-----------X-----------XXXXXX---XXXXXXXXX--------
XXXXXXXXXXXXXXXXXXXXXXXXXXXXXXXXXXXXXXXXXXXXXXXXXXXXXXXXXXXXXXXXXX--XXXXXXXXXXXXXXXXXXXXXXXXXXXXXXXXXXXXXXXXXXXXXXXXXXXXXXXXXXXXXXXXXXXXXXXXXXXXX-XXXXXXXXXXXXXXXXXXXXXXXXXX
