-----------------------------------------------------------------------------------------------------------------------------------------------------------------------------------------------------------------
-----------------------------------------------------------------------------------------------------------------------------------------------------------------------------------------------------------------
-----------------------------------------------------------------------------------------------------------------------------------------------------------------------------------------------------------------
-----------------XX-----------------S?SSSSSSSSSSSSSSSSSSSSSSSSSSSSSSS----------------------------------------------------------------------------------------------------------------------------------XX--------
----------------XXX------------------------------------------------------------------------------------------------------------------------------------------------------------------------------------XX--------
---------------XXXX------------------------------------------------------------------------------------------------------------------------------------------------------------------------------------XX--------
---------------XXXX----------------------------------------------------------------------------------------------------------------------------------------------------------------X----------------X--XX--------
-------------X-XXXX---????--------------------------------------------SS--------------------S?---------SS------SX?-----------------------------------[]---------------------------XX----------------X--XX--------
------------XX-XXXX----------------------------------------------------------------------------------------------------------------------------------[]--------------------------XXX--------------X-X--XX--------
-----------XXX-XXXX---------------------------------------------------------------------------------------------------------[]---------[]------------[]-----[]------------------XXXX-------------XX-X--XX--------
----------XXXX-XXXX---------------------------------------------------------------------------------------------------------[]---------[]------------[]-----[]-----------------XXXXX------------XXX-X--XX--------
XXXXXXXX-XXXXX-XXXXXXXXXXXXXX-XXXXXXXX-XXXX-X-XXX-XXXXXX-XXXXXXXXXXXXXX--XXXX-XXXXXXXXXXXXXXXXXXXXXXXXXXXXXXXXXXXXXXXXXXXXXXXXXXXXX-XXXXX-X-X------XXXXXXXXXXXXXXXXXXXX-X---XXXXXXXXXXXXXXXXXXXXXXX-X--XXXXXXXXXX
