-----------------------------------------------------------------------------------------------------------------------------------------------------------------------------------
-----------------------------------------------------------------------------------------------------------------------------------------------------------------------------------
-----------------------------------------------------------------------------------------------------------------------------------------------------------------------------------
-----------------------------?S---------------------------------------------------------------------------?--------------------------------------------------------------XX--------
----------------------------------------------------------------------------------XSSS-----------------------------------------------------------------------------------XX--------
---------------------------------------------------------------------------------XX----------------------------------------------------------XSS-------------------------XX--------
--------------------------------------------------------------------------------XXX?-----------------------------------XSS-??---------------XX------------------------X--XX--------
---------??-----------------XXX---SS?----------------------------XX-------------XXX-----------------------?-----------XX-------------------XXX--S?-------------------XX--XX--------
--------------------------XXX-----------------------------------XXX-----------X-XXX--SSS-------[]--------------------XXX------------------XXXX----------------------XXX--XX--------
----------------------XXXXX------------------------------------XXXX----------XX-XXX------------[]-------------------XXXX-----------------XXXXX---SSS---------------XXXX--XX--------
-------------------XXXXXX-------------------------------------XXXXX-------------XXX------------[]------------------XXXXX---SSSSS--------XXXXXX--------------------XXXXX--XX--------
XXXXXXXXXXXXX--XXXXXXXXX------XX--XXXXXXXXXXXXXXXX--XXXXXXXXXXXXXXX---XXXXXXXXXXXXXXXX---XXXXXXXXXXXXXXXXXXXXXXXXXXXXXXX-------XX-XXXXXXXXXXXX------XXXXXXXXX---XXXXXXX--XXXXXXXXXX
