-----------------------------------------------------------------------------------------------------------------------------------------------------------------------------------------------
-----------------------------------------------------------------------------------------------------------------------------------------------------------------------------------------------
-----------------------------------------------------------------------------------------------------------------------------------------------------------------------------------------------
---------------?---------------------------------------------------------SSSSSSSS---SSS?--------------?-----------SSS----S??S--------------------------------------------------------XX--------
------------------------------------------------------------------------------------------------------------------------------------------------------------------------------------XXX--------
-----------------------------------------------------------------------------------------------------------------------------------------------------------------------------------XXXX--------
---------------------------------------------------------?------------------------------------------------------------------------------------------------------------------------XXXXX--------
---------?---S?S?S---------------------[]---------[]------------------S?S--------------S-----S?----?--?--?-----S----------SS------X--X----------XX--X------------SS?S------------XXXXXX--------
-------------------------------[]------[]---------[]-----------------------------------------------------------------------------XX--XX--------XXX--XX--------------------------XXXXXXX--------
---------------------[]--------[]------[]---------[]----------------------------------------------------------------------------XXX--XXX------XXXX--XXX-----[]--------------[]-XXXXXXXX--------
---------------------[]--------[]------[]---------[]---------------------------------------------------------------------------XXXX--XXXX----XXXXX--XXXX----[]--------------[]XXXXXXXXX--------
XXXXXXXXXXXXXXXXXXXXXXXXXXXXXXXXXXXXXXXXXXXXXXXXXXXXXXXXXXXXXX--XXXXXXXXXXXXXXX---XXXXXXXXXXXXXXXXXXXXXXXXXXXXXXXXXXXXXXXXXXXXXXXXXXXXXXXXXXXXXXXX--XXXXXXXXXXXXXXXXXXXXXXXXXXXXXXXXXXXXXXXXXXX