------------------------------------------------------------------------------------------------------------------------------------------------------------------------------------------------
------------------------------------------------------------------------------------------------------------------------------------------------------------------------------------------------
------------------------------------------------------------------------------------------------------------------------------------------------------------------------------------------------
-----------------------------------------------------------------------------------S?S------------------------------------------------------------------------------------------------XX--------
--------------------------------------------------------------------------------------------------------------------------------------------------------------------------------------XX--------
-----------------------------------------------------------------------------------------------------------------------------------------------------[]-------------------------------XX--------
-----------------------------------------------------------------------------------------------------------------------------------------------------[]----------------------------X--XX--------
----------------------------------------------------------------------------------XXXXX-----------------------------------------------------X?SS-----XX---------------------------XX--XX--------
-------------------------------------[]-----[]------------------------------------X--------------------------X------------------------------X------------------------------------XXX--XX--------
-------------------------------------[]-----[]------------------------------------X--------------------------X------------------------------X---------------[]------------------XXXX------------
-------------------------------------[]-----[]------------------------------------X--------------------------X------------------------------X---------------[]-----------------XXXXX------------
XXXXXXXXXXXXXXXXXXXXXXXXXXXXXXXXXXXXXXXXXX--XXXXXXXXXXXXXXXXXXXXXXXXXXXXXXXXXXXXXXXXX----XXXXXXXXXXXXXXXXXX--XXXXXXXXXXXXXXXXXXXXXXXXXXXXXXXXXXXX---XXXXXXXXXXXXXXXXXXXXXXXXXXXXXXXXXXXXXXXXXXXX
