-----------------------------------------------------------------------------------------------------------------------------------------------------------------------------------------------------------------
-----------------------------------------------------------------------------------------------------------------------------------------------------------------------------------------------------------------
-----------------------------------------------------------------------------------------------------------------------------------------------------------------------------------------------------------------
----------------S?S-----------------------------------------SSSSS-----SSSS?---------------------------------S---SSSSSSSSS------------?S---SS-------------SSS-------------------------------------------XX--------
-------------------------[]-----------------------------------------------------------------------------[]------------------------------------------------------[]------------------------------------XXX--------
-------------------------[]----------------------------[]-----------------------[]----------------------[]------------------------------------------------------[]-----------------------------------XXXX--------
-------------------------XX----------------------[]----[]-----------------------[]----------------------[]-------------------------SS---------------------------[]----------------------------------XXXXX--------
---SSS------[]---?---[]----------------[]---S?---[]----XX------------------?----[]-------------[]------SXXS------------------------------SSS---------X---SSS----XX-----[]-------[]----------------[]XXXXX--------
------------[]-------[]----------------[]--------[]----------------------[]-----[]-----[]------[]-----------------------------------------------X-[]-X-----------------[]-----[][]----[]----------[]XXXXX--------
------------[]-------[]-----[][]-------[]--------[]---------[]-----[]----[]--[]-[]-----[]------[]-[]--------[]--------------[]--[]-------------XX-[]-XX----------------[]---[][][]----[]---------X[]XXXXX--------
------------[]-------[]-----[][]-------[]--------[]---------[]-----[]----[]--[]-[]-----[]------[]-[]--------[]--------------[]--[]------------XXX-[]-XX----------------[]---[][][]----[]--------XX[]XXXXX--------
XXXXXXXXXXXXXXXXXXXXXXXXXXXXXXXXXXXXXXXXXXXXXXXXXXXXXXXXXXXXXXXXXXXXXXXXXXXXXXXXXXXXXXXXXXXXXXXXXXXXXXXXXXXXXXXXXXXX------XXXXXXXXXXXX-X-XXXXXXXX-XXXXXXXXXXXXXXXXXXXXXXXXXXXXXXXXXXXXXXXXXXXXXXXXXXXXXXXXXXXXXXX
