-------------------------------------------------------------------------------------------------------------------------------------------------------------------------------
-------------------------------------------------------------------------------------------------------------------------------------------------------------------------------
-------------------------------------------------------------------------------------------------------------------------------------------------------------------------------
-------------SSSSSSSSSSS------------???????---------SSS?SSS?SSSS----SSSSSSSSSSSSX--------------------------------------?------------------------------------------------XX-----
--------------------------------------------------------------------------------X--------------------------------------------------------------------------------------XXX-----
--------------------------------------------------------------------------------X-------------------------------------------------------------------------------------XXXX-----
--------------------------------------------------------------------------------X----------------------------------------[]------------------------------------------XXXXX-----
-------------SSSSSSSSSSS-----????---S---------------------[]------S------------?X-[]--------------------???--------------[]-------[]--[]----------------------------XXXXXX-----
----------------------------------------------------------[]--------------------X-[]-------------------------------------[]---[]--[]--[]---------------------------XXXXXXX-----
----------------------------------------------------------[]---------------[]---X-[]-------------------------------------[]---[]--[]--[]--------------------------XXXXXXXX-----
----------------------------------------------------------[]---------------[]---X-[]-------------------------------------[]---[]--[]--[]-------------------------XXXXXXXXX-----
XXXXXXXXXXXXXXXXXXXXXXXX----XXXXXXXXXXXX--------XXXXXXXXXXXXXXXXX----------XXXXXXXXXXXXXXXXXX---XXXXXXXXXXXXXXXXXXXXXXXXXXX---XX--XXXXXXXXXXXXXXXX----XXX----XXXXXXXXXXXXXXXXXX
