-------------------------------------------------------------------------------------------------------------------------------------------------------------------------------------------------
-------------------------------------------------------------------------------------------------------------------------------------------------------------------------------------------------
-------------------------------------------------------------------------------------------------------------------------------------------------------------------------------------------------
----------------------SSSSS?--------------------------------------------------?SS------------------------------SSSSSSS?---------------------------SSSSS--------------SSSS--------------XX--------
--------------------------------------------------------------------------------------------------------------------------------------------------------------------------------------XXX--------
--------------------------------------------------------------XX----------------------------------------------------------------------------------------------------------------------XXX--------
-------------------------------------------------------------XXX------------------SSS-----------------------------------------------------------------------------------------------X-XXX--------
--------XXXX----------SSSSSS------------XX----------------X--XXX-------?????-?---------------------------------SSSSSSSS---------------------SSS------------------?-----------------XX-XXX--------
-------XX-------------------------------XX------[]-------XX--XXX----------------------------------------------------------X--------------------------------------------------------XX-XXX--------
------XXX-----------------------------XXXXX-----[]------XXX--XXX--------------------------------------------[]------------X-----------??------------------------------[]---------X-XX-XXX--------
-----XXXX----------------------------XXXXXX-----[]-----XXXX--XXX--------------------------------------------[]------------X-------------------------------------------[]--------XX-XX-XXX--------
XXXXXXXXXXXXXXXXXXX---XXXXXXXXXXXXXXXXXXXXXXXXXXXXXXXXXXXXX--XXXXXXXXXXXXXXXXXXXXXXXX----XXXXXXXXXXXXXXXXXXXXXXXXXXXXXXX--XXXXXXXXXXXXXXX-------XXXXXXXXXXXXXXXXXXX---XX--XXXXXXXX-XX-XXXXXXXXXXX
