----------------------------------------------------------------------------------------------------------------------------------------------------------------------------------------------------------------------------------------------------------------
----------------------------------------------------------------------------------------------------------------------------------------------------------------------------------------[]----------------------------------------------------------------------
----------------------------------------------------------------------------------------------------------------------------------------------------------------------------------------[]----------------------------------------------------------------------
-----------------------------------------------------------------------------------------------------------------------------------------------------------------------S-----------?----XX-------------------------------------------------------------X--------
-----------------------------------------------------------------------------------------------------------------------S------------------------------------------------------------------------------------------------------------------------------XX--------
----------------------------------------------------------------------------------------------------------------------------------------------------------------------------------------------------------------------------------------------------XXXX--------
------------------------------------------------------------------------------------------------------------------------------------------------------------------------------------?--------------------------------------------------XXX------X--XXXXX--------
--------------------------------------------------------------------------------XX-------------------------------------------------------------------------------------S--------------------------------------------------------------------------XXXXXX--------
-------------[]----------------------------------[]-----------------------------XXX--------------------------------------------------------------------------------[]---------------------------------------X------------------------------------XXXXXXX--------
-------------[]-----------------------------X----[]-----------------------------XXXX-----------------------------------X-------------------------------------------[]---X----[]-----------------X-----------X------[]---------------------------XXXXXXXX--------
-------------[]-----------------------------XX---[]------------------------X----XXXXX-----[]-----XX----------------X---X-------------------------------------------[]---X----[]-----------------X-----------X------[]--------------------------XXXXXXXXX--------
XXXXXXXXXXXXXXXXXXXX[]XXXX[]XXXXXXXXXXX-----XXX--[]XXXXXXXXXXXXXXXXXXXXXXXXX----XXXXXX----[]------XXXXXXXXXXXXXXXXXX---X--XXXXXXXXXXXXXXXXXXXXXXXXXXXXXXXXXXXXXXXXXXXXXXX----XXXXXXXXX----------XXXXXXXXXXXXXXXXXXXXX--XXXXXXXXXXXXXXX--------XXXXXXXXXXXXXXXXXX
