--------------------------------------------------------------------------------------------------------------------------------------------------------------------------------------------------
--------------------------------------------------------------------------------------------------------------------------------------------------------------------------------------------------
--------------------------------------------------------------------------------------------------------------------------------------------------------------------------------------------------
--------------------------------------------------------------------------?--------?SS------------------SS?SSS?SSS--------SS?------------------S?S--S?S--------------------------------XX---------
--------------------------------------------------------------------------------------------------------------------------------------------------------------------------------------XXX---------
--------------------------------------------------------------------------------------------------------------------------------------X---------------------------------X------------XXXX---------
------------?--?----------------------------------------------------------------------------------------------------------SSS--------XX---------------------------------X-----------XXXXX---------
---------?---------SSS---------[]---------------------S--------------XXXXXXXXXX--X--------------[]------SSSSSSSSSSS-----------------XXX--------S?S--S?S--------S?SSS----X----------XXXXXX---------
-------------------------[]----[]-----------------[]----------------XX--------X--X--------------[]---------------------------------XXXX--------------------------------XX---------XXXXXXX---------
-------------------------[]----[]-----------------[]-------[]------XXX--------X--XX-------------[]--------------------------------XXXXX--------------------------------XX--------XXXXXXXX---------
-------------------------[]----[]-----------------[]-------[]-----XXXX--------X--XX-------------[]-------------------------------XXXXXX--------------------------------XX-------XXXXXXXXX---------
XXXXXXXXXXXXXXXXXXXXXXXXXXXXXXXXXXXXXX---XXXXXXXXXXXXXXXXXXXXXXXXXXXXX--------X--XXXXXXXXXXXXXXXXXXXXXXXXXXXXXXXXXXXXXXXX----XXXXXXXXXX--XXXXXXXXXXXXXXXXXXXXXXXXXXXXXXXXX---XXXXXXXXXXXXXXXXXXXXX
